################
#    #    #    #
#              # 
#     ###      #
#     ##       #
#              #
#              #
#              #
#              #
##### ### ######
