!!!!!!!!!!!!!!
!!!!!!!!!!!!!!
!!!!!@@@$!!!!!
!!!!!) %$!!!!!
!!!!!(  $!!!!!
!!!!!=  K!!!!!
!!!!!!!C!!!!!!
!!!!!!!!!!!!!!
!!!!!!!!!!!!!!
