!!!!!!!!!!!!!!
!!!!!@@@$!!!!!
!!!!!   $!!!!!
!!!!!   $!!!!!
!!!!!   $!!!!!
!!!!C   $!!!!!
!!!!!   $!!!!!
!!!!!!!C!!!!!!
!!!!!!!!!!!!!!
