!!!!!!!!!!!!!!
!!@@!!!!!@@@$!
!!E @@@@@ __$!
!!    `   % $!
!!#        #$!
!!*    $!!!!!!
!!e    K!!!!!!
!!!!!!!!!!!!!!
!!!!!!!!!!!!!!
