!!!!!!!!!!!!!!
!!@@!!!!!@@@$!
!!E @@@@@   $!
!!          $!
!!          $!
!!     $!!!!!!
!!     K!!!!!!
!!!!!!!!!!!!!!
!!!!!!!!!!!!!!
