######
#   j#
#    ##o#
#       #
#       #
#       #
#j      #
#######o#
