!!!@@@@@@@$!!!
!!!       $!!!
!!!       $!!!
!!!       $!!!
!!!       I!!!
!!!       $!!!
!!!       $!!!
!!!!!!!!!!!!!!
!!!!!!!!!!!!!!
