!!!!!!!!!!!!!!
!!!!@@@@@$!!!!
!!!!     $!!!!
!!!C     $!!!!
!!!!     $!!!!
!!!!     C!!!!
!!!!     $!!!!
!!!!!!!!!!!!!!
!!!!!!!!!!!!!!
