!!!@@@@@@@$!!!
!!!       $!!!
!!!       $!!!
!!!       $!!!
!!C       $!!!
!!!       $!!!
!!!       $!!!
!!!!!!!!!!!!!!
!!!!!!!!!!!!!!
