!!!!!!!!!!!!!!
!!!!!!!!!!!!!!
!!!!!!A@$!!!!!
!!!!!! ^$!!!!!
!!!!!!) $!!!!!
!!!!!!!!!!!!!!
!!!!!!!!!!!!!!
!!!!!!!!!!!!!!
!!!!!!!!!!!!!!
