!!!!!!!!!!!!!!
!!!!!!!!!!!!!!
!!!!!!A@$!!!!!
!!!!!!  $!!!!!
!!!!!G  $!!!!!
!!!!!!!!!!!!!!
!!!!!!!!!!!!!!
!!!!!!!!!!!!!!
!!!!!!!!!!!!!!
