!!!!!!!!!!!!!!
!!!!!@@@$!!!!!
!!!!!   $!!!!!
!!!!!   $!!!!!
!!!!!   $!!!!!
!!!!S   $!!!!!
!!!!!   $!!!!!
!!!!!!!G!!!!!!
!!!!!!!!!!!!!!
