!!!!!!!!!!!!!!
!!!!!!!!!!!!!!
!!!!!!C@$!!!!!
!!!!!!  $!!!!!
!!!!!C  $!!!!!
!!!!!!!!!!!!!!
!!!!!!!!!!!!!!
!!!!!!!!!!!!!!
!!!!!!!!!!!!!!
