!!!!!!!!!!!!!!
!!!!@@@@@$!!!!
!!!!     $!!!!
!!!G     $!!!!
!!!!     $!!!!
!!!!     K!!!!
!!!!     $!!!!
!!!!!!!!!!!!!!
!!!!!!!!!!!!!!
