!@@$!!!!@@E@@$
!  $!!!!     $
!  $!!!G     K
!  @@@@@     $   
!            $
!            $
!            $
!!!!!!!!!!!!!!
!!!!!!!!!!!!!!
