!!!!!!!!!!!!!!
!!!!!!!!!!!!!!
!!!!!!A$!!!!!!
!!!!!!&$!!!!!!
!!!!!G&$!!!!!!
!!!!!!&$!!!!!!
!!!!!!C!!!!!!!
!!!!!!!!!!!!!!
!!!!!!!!!!!!!!
