!@@@@A@$@B@@@$
!  X   $     $
!      $     $
!            $
!            $
!  !!! $     $
!    ! $     $
!    ! $    Y$
!!!!!!!!!!!!!!
