!!!!!!!!!!!!!!
!!!!!!@@$!!!!!
!!!!!!C $!!!!!
!!!!!!  $!!!!!
!!!!!C  C!!!!!
!!!!!!  $!!!!!
!!!!!!C!!!!!!!
!!!!!!!!!!!!!!
!!!!!!!!!!!!!!
