!!!!!!!!!!!!!!
!!!!!@@$!!!!!!
!!!!! %$!!!!!!
!!!!!  $A$!!!!
!!!!!`   $!!!!
!!!!!`  &$!!!!
!!!!!    $!!!!
!!!!!!C!!!!!!!
!!!!!!!!!!!!!!
