!!!@@@@$!!!!!!
!!!    $!!!!!!
!!!    $!!!!!!
!!!    $@A$!!!
!!!       $!!!
!!!       $!!!
!!!       $!!!
!!!!!!!!C!!!!!
!!!!!!!!!!!!!!
