!!!!!!!!!!!!!!
!!!!!!!@A@@$!!
!!!!!!!    $!!
!!!!!!!    $!!
!!!!!!!    $!!
!!!!!!!    $!!
!!S       X$!!
!!!!!!!!!!!!!!
!!!!!!!!!!!!!!
