!!!@@@@$!!!!!!
!!!    $!!!!!!
!!!    $!!!!!!
!!!    $@C$!!!
!!!       $!!!
!!!       $!!!
!!!       $!!!
!!!!!!!!C!!!!!
!!!!!!!!!!!!!!
