!@@@@@@@@@@@@$
!            $
!            $
!     !!!    $
!     !!I    $
!     % /    $
!            $
!            $
!!!!!C!!D!!!!!
