!!!!!!!!!!!!!!
!!!!!@@@$!!!!!
!!!!!  %$!!!!!
!!!!!(  $!!!!!
!!!!!   $!!!!!
!!!!G + $!!!!!
!!!!!)  $!!!!!
!!!!!!!C!!!!!!
!!!!!!!!!!!!!!
