!!!!!!!!!!!!!!
!!!!!@@@$!!!!!
!!!!!   $!!!!!
!!!!!   $!!!!!
!!!!!   $!!!!!
!!!!G   $!!!!!
!!!!!   $!!!!!
!!!!!!!C!!!!!!
!!!!!!!!!!!!!!
