!!!!!!!!!!!!!!
!!!!@@@@@$!!!!
!!!! =  l$!!!!
!!!G     $!!!!
!!!! &&  $!!!!
!!!!     K!!!!
!!!!% +  $!!!!
!!!!!!!!!!!!!!
!!!!!!!!!!!!!!
