!!!!!!!!!!!!!!
!!!!!!!!!!!!!!
!!!!!!@C$!!!!!
!!!!!!  $!!!!!
!!!!!!  $!!!!!
!!!!!!  $!!!!!
!!!!!!!!!!!!!!
!!!!!!!!!!!!!!
!!!!!!!!!!!!!!
