!!!!!!!!!!!!!!
!!!!!!!!!!!!!!
!!!!!@@@$!!!!!
!!!!!  ($!!!!!
!!!!!  )$!!!!!
!!!!!=  K!!!!!
!!!!!!!C!!!!!!
!!!!!!!!!!!!!!
!!!!!!!!!!!!!!
