!!!!!!!!!!!!!!
!!!!!!!!!!!!!!
!!!!!!A@$!!!!!
!!!!!!  $!!!!!
!!!!!G `$!!!!!
!!!!!!!!!!!!!!
!!!!!!!!!!!!!!
!!!!!!!!!!!!!!
!!!!!!!!!!!!!!
