!!@@@@@@@@@$!!
!! *     __$!!
!!         $!!
!!     $   $!!
!!  $M $   $!!
!!  $!E!   $!!
!!  $!!!   $!!
!!- $!!!  =$!!
!!!!!!!!!!!!!!
