!@@@@@@@@@@@@$
!__         /$
!            $
!     !!!    $
!    ~!!I    $
!     %     #$
!=          #$
!            $
!!!!!C!!D!!!!!
