!!!!!!!!!!!!!!
!!!!!!!!!!!!!!
!!!!!@@@$!!!!!
!!!!!   $!!!!!
!!!!!   C!!!!!
!!!!!C  $!!!!!
!!!!!!!!!!!!!!
!!!!!!!!!!!!!!
!!!!!!!!!!!!!!
