!@@$!!!!@@E@@$
!]%$!!!!     $
!j $!!!G     K
!  @@@@@     $   
!            $
!`      +   %$
!  % ~     = $
!!!!!!!!!!!!!!
!!!!!!!!!!!!!!
