!!!!!!!!!!!!!!
!!!!!!!!!!!!!!
!!!!!!@A$!!!!!
!!!!!!I $!!!!!
!!!!!!  K!!!!!
!!!!!!C!!!!!!!
!!!!!!!!!!!!!!
!!!!!!!!!!!!!!
!!!!!!!!!!!!!!
