!!!!!!!!!!!!!!
!!!!!!!!!!!!!!
!!!!!!@A$!!!!!
!!!!!!  $!!!!!
!!!!!!  $!!!!!
!!!!!!  $!!!!!
!!!!!!!!!!!!!!
!!!!!!!!!!!!!!
!!!!!!!!!!!!!!
