!!!!!!!!!!!!!!
!!!!@@@@@$!!!!
!!!!     $!!!!
!!!!     $!!!!
!!!G     $!!!!
!!!!     $!!!!
!!!!!C!!!!!!!!
!!!!!!!!!!!!!!
!!!!!!!!!!!!!!
