!!!@@@@@@@$!!!
!!!       $!!!
!!!       $!!!
!!!       $!!!
!!!       S!!!
!!!       $!!!
!!!       $!!!
!!!!!!!!!!!!!!
!!!!!!!!!!!!!!
