!!!@@@@$!!!!!!
!!!f   $!!!!!!
!!!    $!!!!!!
!!!    $@A$!!!
!!!       $!!!
!!!       $!!!
!!!       $!!!
!!!!!!!!C!!!!!
!!!!!!!!!!!!!!
