!!!!!!!!!!!!!!
!!!!!@@$!!!!!!
!!!!!  $!!!!!!
!!!!!  $A$!!!!
!!!!!    $!!!!
!!!!!    $!!!!
!!!!!    $!!!!
!!!!!!G!!!!!!!
!!!!!!!!!!!!!!
