!@@$!!!!@@C@@$
!  $!!!!     $
!  $!!!C     C
!  @@@@@     $   
!            $
!            $
!            $
!!!!!!!!!!!!!!
!!!!!!!!!!!!!!
