!!@@@@@@@@@$!!
!!         $!!
!!         $!!
!!     $   $!!
!!  $X $   $!!
!!  $!N!   $!!
!!  $!!!   $!!
!!  $!!!   $!!
!!!!!!!!!!!!!!
