!@@@@A@@@@@@$!
!      Y    $!
!           $!
!           $!
X      !    $!
!      !    $!
!      !    $!
!      !Z   $!
!M!N!!!!!!!!!!
