!@@@@$
!    $
!    @@@$
!       $
!       $
!       $
!       $
!!!!!!!!!
