!!!!!!!!!!!!!!
!!@@!!!!!@@@$!
!!E @@@@@   $!
!!          $!
!!          $!
!!     $!!!!!!
!!e    K!!!!!!
!!!!!!!!!!!!!!
!!!!!!!!!!!!!!
