!!!!!!!!!!!!!!
!!!!!!!!!!!!!!
!!!!!!@$!!!!!!
!!!!!! $!!!!!!
!!!!!C $!!!!!!
!!!!!! $!!!!!!
!!!!!!C!!!!!!!
!!!!!!!!!!!!!!
!!!!!!!!!!!!!!
