!!!!!!!!!!!!!!
!!!!!!!!!!!!!!
!!!!!@@A$!!!!!
!!!!!   K!!!!!
!!!!!   $!!!!!
!!!!!   $!!!!!
!!!!!!!!!!!!!!
!!!!!!!!!!!!!!
!!!!!!!!!!!!!!
