!!!@@@@@@@$!!!
!!!       $!!!
!!!       $!!!
!!!       $!!!
!!X       $!!!
!!!       $!!!
!!!       $!!!
!!!!!!!!!!!!!!
!!!!!!!!!!!!!!
