!!@@@@@@@@@$!!
!!%*     __$!!
!!         $!!
!!     $   $!!
!!  $M $   $!!
!!  $!E!   $!!
!!  $!!! % $!!
!!- $!!!  =$!!
!!!!!!!!!!!!!!
