!!!!!!!!!!!!!!
!!!!@@@@@$!!!!
!!!!     $!!!!
!!!S     $!!!!
!!!!     $!!!!
!!!!     T!!!!
!!!!     $!!!!
!!!!!!!!!!!!!!
!!!!!!!!!!!!!!
