!!!!!!!!!!!!!!
!!!!!@@$!!!!!!
!!!!!  $!!!!!!
!!!!!  $A$!!!!
!!!!!    $!!!!
!!!!!    $!!!!
!!!!!    $!!!!
!!!!!!C!!!!!!!
!!!!!!!!!!!!!!
