!!!!!!!!!!!!!!
!!!!!!!@A@@$!!
!!!!!!!    $!!
!!!!!!!    $!!
!!!!!!!    $!!
!!!!!!!    $!!
!!G       O$!!
!!!!!!!!!!!!!!
!!!!!!!!!!!!!!
