!!!!!!!!!!!!!!
!!!!!!!!!!!!!!
!!!!!@@@$!!!!!
!!!!!   $!!!!!
!!!!!   $!!!!!
!!!!!   S!!!!!
!!!!!!!G!!!!!!
!!!!!!!!!!!!!!
!!!!!!!!!!!!!!
