!@@@@@@@@@@@@$
!            $
!            $
!            $
!      S     $
!            $
!            $
!            $
!            $
!!!!!!!!!!!!!!
