!@@@@@@@@@@@@$
!            $
!            $
!     !!!    $
!     !!C    $
!            $
!            $
!            $
!!!!!C!!C!!!!!
