!@@@@@@@@@@@@$
!            $
!            $
!     !!!    $
!     !!X    $
!     %      $
!            $
!            $
!!!!!G!!H!!!!!
