!!!!!!!!!!!!!!
!!!!!@@$!!!!!!
!!!!!  $!!!!!!
!!!!!  $C$!!!!
!!!!!    $!!!!
!!!!!    $!!!!
!!!!!    $!!!!
!!!!!!C!!!!!!!
!!!!!!!!!!!!!!
