!@@@@@@@@@@@@$
!            $
!            $
!            $
!            $
!            $
!            $
!            $
!!!!!!C!!!!!!!
