!@@@@@@@@@@@@$
!            $
!            $
!     !!!    $
!     !!I    $
!     %      $
!            $
!            $
!!!!!C!!D!!!!!
