!!!!!!!!!!!!!!
!!!!!!!!!!!!!!
!!!!!!@@$!!!!!
!!!!!G  $!!!!!
!!!!!! c$!!!!!
!!!!!!C!!!!!!!
!!!!!!!!!!!!!!
!!!!!!!!!!!!!!
!!!!!!!!!!!!!!
