!!!!!!!!!!!!!!
!!!!!!!@A@@$!!
!!!!!!!    $!!
!!!!!!!+   $!!
!!!!!!!  & $!!
!!!!!!!{   $!!
!!G       O$!!
!!!!!!!!!!!!!!
!!!!!!!!!!!!!!
