!!!!!!!!!!!!!!
!!@@!!!!!@@@$!
!!M @@@@@   $!
!!          $!
!!          $!
!!     $!!!!!!
!!     S!!!!!!
!!!!!!!!!!!!!!
!!!!!!!!!!!!!!
