!!!!!!!!!!!!!!
!!!!!!!!!!!!!!
!!!!!!A@$!!!!!
!!!!!! ^$!!!!!
!!!!!!% $!!!!!
!!!!!!!!!!!!!!
!!!!!!!!!!!!!!
!!!!!!!!!!!!!!
!!!!!!!!!!!!!!
