!@@@@A@@@@@@$!
!      I    $!
!           $!
!         & $!
O     *=    $!
!      )    $!
!      (    $!
!      !P   $!
!M!N!!!!!!!!!!
