!!!!!!!!!!!!!!
!!!!!!!@A@@$!!
!!!!!!!   %$!!
!!!!!!!+   $!!
!!!!!!!% & $!!
!!!!!!!{   $!!
!!G       O$!!
!!!!!!!!!!!!!!
!!!!!!!!!!!!!!
