!!!!!!!!!!!!!!
!!!!!!!!!!!!!!
!!!!!!C@$!!!!!
!!!!!!  $!!!!!
!!!!!!  $!!!!!
!!!!!!!!!!!!!!
!!!!!!!!!!!!!!
!!!!!!!!!!!!!!
!!!!!!!!!!!!!!
