!!!!!!!!!!!!!!
!!!!!!!!!!!!!!
!!!!!@@A$!!!!!
!!!!!X  $!!!!!
!!!!!   $!!!!!
!!!!!   $!!!!!
!!!!!!!G!!!!!!
!!!!!!!!!!!!!!
!!!!!!!!!!!!!!
