!@@@@!
!    !
!    @@@!
!       !
!       !
!       !
!       !
!!!!!!!!!
