!!!!!!!!!!!!!!
!!!!!!!!!!!!!!
!!!!!!A@$!!!!!
!!!!!! %$!!!!!
!!!!!G `$!!!!!
!!!!!!!!!!!!!!
!!!!!!!!!!!!!!
!!!!!!!!!!!!!!
!!!!!!!!!!!!!!
