!!!!!!!!!!!!!!
!!!!!@@@@$!!!!
!!!!!    $!!!!
!!!!!    $!!!!
!!!!!    s!!!!
!!!!!    $!!!!
!!!!!!!!!!!!!!
!!!!!!!!!!!!!!
!!!!!!!!!!!!!!
