!!!@@@@$!!!!!!
!!!f   $!!!!!!
!!! && $!!!!!!
!!!    $@A$!!!
!!!  *    $!!!
!!! *+*   $!!!
!!!  *    $!!!
!!!!!!!!C!!!!!
!!!!!!!!!!!!!!
