!!!!!!!!!!!!!!
!!!!!!!!!!!!!!
!!!!!@@@$!!!!!
!!!!!   $!!!!!
!!!!!   $!!!!!
!!!!!   K!!!!!
!!!!!!!C!!!!!!
!!!!!!!!!!!!!!
!!!!!!!!!!!!!!
