!!!@@@@$!!!!!!
!!!f  %$!!!!!!
!!! && $!!!!!!
!!!    $@A$!!!
!!!       $!!!
!!! *=    $!!!
!!!%      $!!!
!!!!!!!!C!!!!!
!!!!!!!!!!!!!!
