!!@@@@@@@@@$!!
!!         $!!
!!         $!!
!!     $   $!!
!!  $C $   $!!
!!  $!C!   $!!
!!  $!!!   $!!
!!  $!!!   $!!
!!!!!!!!!!!!!!
