!!!!!!!!!!!!!!
!!!!!!!!!!!!!!
!!!!!!A$!!!!!!
!!!!!! $!!!!!!
!!!!!S $!!!!!!
!!!!!! $!!!!!!
!!!!!!G!!!!!!!
!!!!!!!!!!!!!!
!!!!!!!!!!!!!!
