!!!!!!!!!!!!!!
!!!!!!!!!!!!!!
!!!!!@@A$!!!!!
!!!!!O  $!!!!!
!!!!!   $!!!!!
!!!!!a  $!!!!!
!!!!!!!C!!!!!!
!!!!!!!!!!!!!!
!!!!!!!!!!!!!!
