!!!!!!!!!!!!!!
!!!!!!@@$!!!!!
!!!!!!E#$!!!!!
!!!!!!  $!!!!!
!!!!!G  K!!!!!
!!!!!!  $!!!!!
!!!!!!C!!!!!!!
!!!!!!!!!!!!!!
!!!!!!!!!!!!!!
