!!!!!!!!!!!!!!
!!!!!!!!!!!!!!
!!!!!@@C$!!!!!
!!!!!   C!!!!!
!!!!!   $!!!!!
!!!!!   $!!!!!
!!!!!!!!!!!!!!
!!!!!!!!!!!!!!
!!!!!!!!!!!!!!
