!!!!!!!!!!!!!!
!!!!!!!!!!!!!!
!!!!!@@C$!!!!!
!!!!!C  $!!!!!
!!!!!   $!!!!!
!!!!!   $!!!!!
!!!!!!!C!!!!!!
!!!!!!!!!!!!!!
!!!!!!!!!!!!!!
