!@@$!!!!@@E@@$
!  $!!!!     $
!j $!!!G     K
!  @@@@@     $   
!            $
!            $
!            $
!!!!!!!!!!!!!!
!!!!!!!!!!!!!!
