!!!!!!!!!!!!!!
!!!!!!@@$!!!!!
!!!!!!M $!!!!!
!!!!!!  $!!!!!
!!!!!S  T!!!!!
!!!!!!  $!!!!!
!!!!!!G!!!!!!!
!!!!!!!!!!!!!!
!!!!!!!!!!!!!!
