!!!!!!!!!!!!!!
!!!!!!!!!!!!!!
!!!!!@@A$!!!!!
!!!!!(  K!!!!!
!!!!!)  $!!!!!
!!!!!=  $!!!!!
!!!!!!!!!!!!!!
!!!!!!!!!!!!!!
!!!!!!!!!!!!!!
