!@@@@A@$@B@@@$
!  I   $     $
!      $     $
!            $
!            $
!  !!! $     $
!    ! $     $
!    ! $    J$
!!!!!!!!!!!!!!
