!!!!!!!!!!!!!!
!!@@!!!!!@@@$!
!!C @@@@@   $!
!!          $!
!!          $!
!!     $!!!!!!
!!     C!!!!!!
!!!!!!!!!!!!!!
!!!!!!!!!!!!!!
