!!!!!!!!!!!!!!
!!!!!!!!!!!!!!
!!!!!@@@$!!!!!
!!!!!)  $!!!!!
!!!!!(  $!!!!!
!!!!!=  K!!!!!
!!!!!!!C!!!!!!
!!!!!!!!!!!!!!
!!!!!!!!!!!!!!
