!!@@@@@@@@@$!!
!!         $!!
!!         $!!
!!     $   $!!
!!  $M $   $!!
!!  $!E!   $!!
!!  $!!!   $!!
!!  $!!!   $!!
!!!!!!!!!!!!!!
