######
#o  o#
#   o#
#j o #
######
