!!!!!!!!!!!!!!
!!!!!!!!!!!!!!
!!!!!!@A$!!!!!
!!!!!!M $!!!!!
!!!!!!  S!!!!!
!!!!!!G!!!!!!!
!!!!!!!!!!!!!!
!!!!!!!!!!!!!!
!!!!!!!!!!!!!!
