!!!!!!!!!!!!!!
!!!!!!!!!!!!!!
!!!!!!@A$!!!!!
!!!!!!I&$!!!!!
!!!!!!  K!!!!!
!!!!!!C!!!!!!!
!!!!!!!!!!!!!!
!!!!!!!!!!!!!!
!!!!!!!!!!!!!!
