!@@$!!!!@@E@@$
!] $!!!!     $
!j $!!!G     K
!  @@@@@     $   
!            $
!`      +    $
!    ~     = $
!!!!!!!!!!!!!!
!!!!!!!!!!!!!!
