!!!!!!!!!!!!!!
!!!!@@@@@$!!!!
!!!!    g$!!!!
!!!!     $!!!!
!!!G    `$!!!!
!!!!     $!!!!
!!!!!C!!!!!!!!
!!!!!!!!!!!!!!
!!!!!!!!!!!!!!
