!!!!!!!!!!!!!!
!!!!!!!!!!!!!!
!!!!!!@@$!!!!!
!!!!!!  $!!!!!
!!!!!S  $!!!!!
!!!!!!  $!!!!!
!!!!!!!!!!!!!!
!!!!!!!!!!!!!!
!!!!!!!!!!!!!!
