!@@@@$
!    $
!    $
!    $@C$
!       $
!       $
!       $
!!!!!!C!!
