######
#    #
#    ####
#       #
#       #
#       #
#       #
#########
