!!!!!!!!!!!!!!
!!!!!!!!!!!!!!
!!!!!!@C$!!!!!
!!!!!!C $!!!!!
!!!!!!  C!!!!!
!!!!!!C!!!!!!!
!!!!!!!!!!!!!!
!!!!!!!!!!!!!!
!!!!!!!!!!!!!!
