!@@$!!!!@@M@@$
!  $!!!!     $
!  $!!!S     T
!  @@@@@     $   
!            $
!            $
!            $
!!!!!!!!!!!!!!
!!!!!!!!!!!!!!
