!!!!!!!!!!!!!!
!!!!!!!!!!!!!!
!!!!!!A$!!!!!!
!!!!!! $!!!!!!
!!!!!G $!!!!!!
!!!!!! $!!!!!!
!!!!!!C!!!!!!!
!!!!!!!!!!!!!!
!!!!!!!!!!!!!!
