!@@@@A@$@B@@@$
!  I   $    _$
!      $+    $
!         && $
!    *    && $
!  === $     $
!    ) $     $
!    = $    J$
!!!!!!!!!!!!!!
