!@@@@C@$@C@@@$
!  C   $     $
!      $     $
!            $
!            $
!  !!! $     $
!    ! $     $
!    ! $    C$
!!!!!!!!!!!!!!
