!!!!!!!!!!!!!!
!!!!!!@@$!!!!!
!!!!!!E $!!!!!
!!!!!!  $!!!!!
!!!!!G  K!!!!!
!!!!!!  $!!!!!
!!!!!!C!!!!!!!
!!!!!!!!!!!!!!
!!!!!!!!!!!!!!
