!!!!!!!!!!!!!!
!!!!!!!@C@@$!!
!!!!!!!    $!!
!!!!!!!    $!!
!!!!!!!    $!!
!!!!!!!    $!!
!!C        @!!
!!!!!!!!!!!!!!
!!!!!!!!!!!!!!
