!!!!!!!!!!!!!!
!!!!!!!!!!!!!!
!!!!!@@A$!!!!!
!!!!!   S!!!!!
!!!!!   $!!!!!
!!!!!   $!!!!!
!!!!!!!!!!!!!!
!!!!!!!!!!!!!!
!!!!!!!!!!!!!!
