!!!!!!!!!!!!!!
!!!!!@@@@$!!!!
!!!!!    $!!!!
!!!!!h   $!!!!
!!!!!`   K!!!!
!!!!!    $!!!!
!!!!!!!!!!!!!!
!!!!!!!!!!!!!!
!!!!!!!!!!!!!!
