!!!!!!!!!!!!!!
!!!!!!!!!!!!!!
!!!!!!@A$!!!!!
!!!!!![ $!!!!!
!!!!!!  $!!!!!
!!!!!!i^$!!!!!
!!!!!!!!!!!!!!
!!!!!!!!!!!!!!
!!!!!!!!!!!!!!
