!!!!!!!!!!!!!!
!!!!!@@@@$!!!!
!!!!!    $!!!!
!!!!!    $!!!!
!!!!!    S!!!!
!!!!!    $!!!!
!!!!!!!!!!!!!!
!!!!!!!!!!!!!!
!!!!!!!!!!!!!!
