!!!!!!!!!!!!!!
!!!!@@@@@$!!!!
!!!!     $!!!!
!!!!     $!!!!
!!!S     $!!!!
!!!!     $!!!!
!!!!!G!!!!!!!!
!!!!!!!!!!!!!!
!!!!!!!!!!!!!!
