!!!!!!!!!!!!!!
!!!!!!!!!!!!!!
!!!!!!@@$!!!!!
!!!!!G& $!!!!!
!!!!!!%c$!!!!!
!!!!!!C!!!!!!!
!!!!!!!!!!!!!!
!!!!!!!!!!!!!!
!!!!!!!!!!!!!!
